10 10
100
1
Resources/GRASS+.png
1 1 0 0 0 0 1
1 3 0 0 0 0 0
2 2 0 0 0 1 1
2 5 0 0 0 0 1
3 1 0 0 0 0 0
3 3 0 0 0 1 1
4 2 0 0 0 1 1
4 3 0 0 0 1 1
4 5 0 0 0 0 0
4 6 0 0 0 0 0
5 3 0 0 0 0 1
6 1 0 0 0 1 1
6 2 0 0 0 0 0
6 4 0 0 0 0 1
6 5 0 0 0 1 1
7 6 0 0 0 1 1
8 4 0 0 0 0 0
